1111111111111111111111111111111111111111111111111111111111111111111111
1000000001000000000000000010000000110000000000000000000000000000000001
1000000001000000000000000001000000110000000000000000000000000000000001
1000000001000000000000000000100000110000000000000000000000000000000001
1111000111000000000000000000010000110000000000000000000000000000000001
1000000000000000000000000000000000000000000000000000000000000000000001
1000000000000000000000000000000000000000000000000000000000000000000001
1000000000000000000000000000000000000000000000000000000000000000000001
1000000000000000000000000000000000000000000000000000000000000000000001
1111100000000000000000000000000000000000000000000000000000000000000001
1000000000000000000000000000000000000000000000000000000000000000000001
1000000000000000000000000000000000000000000000000000000000000000000001
1000000000000000000000000000000000000000000011111111111100000000000001
1000000000000000000000000000000000000000000000000000000100000000000001
1000000000000000000000000000000000000000000000000000000100000000000001
1000000000000000000000000000000000000000000000000000000100000000000001
1000000000000000000000000000000000000000000011111111111100000000000001
1000000000000000000000000000000000000000000000000000000000000000000001
1000000000000000000000000000000000000000000000000000000000000000000001
1111111111111000000000000000000000000000000000000000000000000000000001
1000000000000000000000000000000000000000000000000000000000000000000001
1000000000000000000000000000000000000000000000000000000000000000000001
1000000000001000000000000000000000000000000000000000000000000000000001
1000000000001000000000000000000000000000000000000000000000000000000001
1111111111111111111111111111111111111111111111111111111111111111111111