1111111111111111111111111111111111111111111111111111111111111111111111
1000000001000000010000000000000000110000000000000000000000000000000001
1000000001000100010000000000000000110000000000000000000000000000000001
1000011101111100010000000000000000110000000000000000000000000000000001
1000000101000001110000000000000000110000000000000000000000000000000001
1000000101100110000000000000000000000000000000000000000000000000000001
1000000100000100000000000000000000000000000000000000000000000000000001
1000000111111100000000000000000000000000000000000000000000000000000001
1000000000000000000000000000000000000000000000000000000000000000000001
1000000000000000000000000000000000000000000000000000000000000000000001
1000000000000000000000000000000000000000000000000000000000000000000001
1000000000000000000000000000000000000000000000000000000000000000000001
1000000000000000000000000000000000000000000011111111111100000000000001
1000000000000000000000000000000000000000000000000000000100000000000001
1000000000000000000000000000000000000000000000000000000100000000000001
1000000000000000000000000000000000000000000000000000000100000000000001
1000000000000000000000000000000000000000000011111111111100000000000001
1000000000000000000000000000000000000000000000000000000000000000000001
1000000000000000000000000000000000000000000000000000000000000000000001
1111111111111000000000000000000000000000000000000000000000000000000001
1000000000000000000000000000000000000000000000000000000000000000000001
1000000000000000000000000000000000000000000000000000000000000000000001
1000000000001000000000000000000000000000000000000000000000000000000001
1000000000001000000000000000000000000000000000000000000000000000000001
1111111111111111111111111111111111111111111111111111111111111111111111